14,14,14,14,14,14,14,14,14,14,14,14,14,14,14,14,14,14,14,14,14,14,14,14,14,14,14,14,14,14,14,14,14,14,14,14,14,14,14,14,14,14,14,14,14,14,14,14,14,14,15,9,8,8,8,8,8,8,8,9,6,6,6,6,6,5,5,5,11,11,11,11,11,5,5,5,6,6,6,6,6,6,6,7,14,14,14,14,5,5,5,5,5,5,5,5,5,5,5,5
15,2,2,2,2,2,2,2,2,5,5,5,5,5,5,5,5,5,5,5,2,2,2,2,2,1,1,1,1,1,1,1,1,1,1,1,1,1,1,1,1,1,1,1,2,2,2,2,2,24,24,9,21,21,21,21,21,21,21,9,24,0,0,0,0,5,11,11,18,18,18,18,18,11,11,5,0,0,2,2,2,2,2,7,0,0,0,0,5,4,4,4,4,4,4,4,4,4,4,5
15,2,2,2,2,2,2,2,2,5,11,11,11,11,11,11,11,11,11,5,2,2,2,2,2,1,1,1,1,1,1,1,1,1,1,1,1,1,1,1,1,1,1,1,2,2,2,2,2,24,24,9,21,21,21,21,21,21,21,9,24,0,0,0,5,5,18,18,18,18,18,18,18,18,18,5,5,0,2,2,2,2,2,7,0,0,0,0,5,18,18,18,18,18,18,18,18,18,18,5
15,1,1,1,1,1,1,1,2,5,17,17,17,17,17,17,17,17,17,5,2,2,2,2,2,1,1,1,1,1,1,1,1,1,1,1,1,1,1,1,1,1,1,1,2,2,2,2,2,24,24,9,21,21,21,21,21,21,21,9,24,0,0,0,4,5,18,18,18,18,18,18,18,18,18,5,4,0,2,2,2,2,2,7,0,0,0,0,5,18,18,18,18,18,18,18,18,18,18,5
15,1,1,1,1,1,1,1,2,5,17,17,17,17,17,17,17,17,17,5,2,2,2,2,2,1,1,1,1,1,1,1,1,1,1,1,1,1,1,1,1,1,1,1,2,2,2,2,2,24,24,9,21,21,21,21,21,21,21,9,24,0,0,0,0,5,18,18,18,18,18,18,18,18,18,5,0,0,2,2,2,2,2,7,0,0,0,0,5,18,18,18,18,18,18,18,18,18,18,5
15,1,1,1,1,1,1,1,2,5,17,17,17,17,17,17,17,17,17,5,2,2,2,2,2,1,1,1,1,1,1,1,1,1,1,1,1,1,1,1,1,1,1,1,2,2,2,2,2,24,24,9,9,9,9,21,9,9,9,9,24,0,0,0,0,5,5,5,5,5,18,5,5,5,5,5,0,0,2,2,2,2,2,7,0,0,0,0,5,3,3,3,3,3,3,3,3,3,3,5
15,1,1,1,1,1,1,1,2,5,17,17,17,17,17,17,17,17,17,5,2,2,2,2,2,1,1,1,1,1,1,1,1,1,1,1,1,1,1,1,1,1,1,1,2,2,2,2,2,24,24,8,8,8,8,21,8,8,8,8,24,0,0,0,0,4,4,4,4,5,18,5,4,4,4,4,0,0,2,2,2,2,2,7,0,0,0,0,5,3,3,3,3,3,3,3,3,3,3,5
15,1,1,1,1,1,1,1,2,5,17,17,17,17,17,17,17,17,17,5,2,2,2,2,2,2,1,1,1,1,1,1,1,1,1,1,1,1,1,1,1,1,1,1,2,2,2,2,2,24,24,24,24,24,24,24,24,24,24,24,24,0,0,0,0,0,0,0,0,4,0,4,0,0,0,0,0,0,2,2,2,2,2,7,0,0,0,0,5,3,3,3,3,3,3,3,3,3,3,5
15,1,1,1,1,1,1,1,2,5,5,5,5,5,5,17,5,5,5,5,2,2,2,2,2,1,1,1,1,1,1,1,1,1,1,1,1,1,1,1,1,1,1,1,2,2,2,2,2,2,2,2,2,2,2,2,2,2,2,2,2,0,0,5,0,0,0,0,0,0,0,0,0,0,0,0,0,5,2,2,2,2,2,7,0,0,0,0,5,3,3,3,3,3,3,3,3,3,3,5
15,1,1,1,1,1,1,1,2,4,4,4,4,4,4,16,4,4,4,4,2,2,2,2,2,1,1,1,1,1,1,1,1,1,1,1,1,1,1,1,1,1,1,1,2,2,2,2,2,2,15,15,15,15,15,7,2,2,2,2,2,0,0,4,5,0,0,0,0,0,0,0,0,0,0,0,5,4,2,2,2,2,2,7,0,0,0,0,5,3,3,3,3,3,3,3,3,3,3,5
15,1,1,1,1,1,1,1,2,2,1,1,1,1,1,1,1,1,1,1,2,2,2,2,2,1,1,1,1,1,1,1,1,1,1,1,1,1,1,1,1,1,1,1,2,2,2,2,2,2,15,14,14,14,14,7,2,2,2,2,2,2,2,2,4,2,2,2,2,2,2,2,2,2,2,2,4,2,2,2,2,2,2,7,0,0,0,0,5,3,3,3,3,3,3,3,3,3,3,5
15,1,1,1,1,1,1,1,2,2,1,1,1,1,1,1,1,1,1,1,2,2,2,2,2,1,1,1,1,1,1,1,1,1,1,1,1,1,1,1,1,1,1,1,2,2,2,2,2,2,15,0,0,0,0,7,2,2,2,2,2,2,2,2,2,2,2,2,2,2,2,2,2,2,2,2,2,2,2,2,2,2,2,7,0,0,0,0,5,5,5,5,5,5,3,5,5,5,5,5
15,1,16,16,1,1,1,1,2,2,1,1,1,1,1,1,1,1,1,1,2,2,2,2,2,1,1,1,1,1,1,1,1,1,1,1,1,1,1,1,1,1,1,1,2,2,2,2,2,2,15,0,0,0,0,7,2,2,2,2,2,2,2,2,2,2,2,2,2,2,2,2,2,2,2,2,2,2,2,2,2,2,2,7,14,14,0,14,4,4,4,4,4,4,3,4,4,4,4,8
15,1,16,16,1,1,1,1,2,2,2,2,2,2,2,2,2,2,2,2,2,2,2,2,2,1,1,1,1,1,1,1,1,1,1,1,1,1,1,1,1,1,1,1,2,2,2,2,2,2,15,0,0,0,0,7,2,2,2,2,2,2,2,2,2,2,2,2,2,2,2,2,2,2,2,2,2,2,2,2,2,2,2,7,0,0,0,0,2,2,2,2,2,2,2,2,2,2,2,8
15,14,16,16,14,14,2,2,2,2,2,2,2,2,2,2,2,2,2,2,2,2,2,2,2,1,1,1,1,1,1,1,1,1,1,1,1,1,1,1,1,1,1,1,2,2,2,2,2,2,15,0,0,0,0,7,2,2,2,2,2,2,2,2,2,2,2,2,2,2,2,2,2,2,2,2,2,2,2,2,2,2,2,7,0,0,0,0,2,2,2,2,2,2,2,2,2,2,2,8
15,16,16,16,16,14,2,2,2,2,2,2,2,2,2,2,2,2,2,2,2,2,2,2,2,1,1,1,1,1,1,1,1,1,1,1,1,1,1,1,1,1,1,1,2,2,2,2,2,2,15,0,0,0,0,7,2,2,2,2,2,2,2,2,2,2,2,2,2,2,2,2,2,2,2,2,2,2,2,2,2,2,2,7,0,0,0,0,2,2,2,9,9,9,9,9,9,9,9,9
14,16,16,16,16,14,14,14,14,14,14,14,14,14,14,14,14,14,14,14,14,14,14,14,14,14,14,14,14,14,14,14,14,14,14,14,14,14,14,14,14,14,14,14,14,14,14,14,14,14,14,0,0,0,0,6,6,6,6,6,6,6,6,6,6,6,6,6,6,6,6,6,6,1,6,6,6,6,6,6,6,6,6,6,0,0,0,0,2,2,2,9,10,10,10,10,10,10,10,9
7,0,0,0,0,0,0,0,0,0,0,0,0,0,0,0,0,0,0,0,0,0,0,0,0,0,0,0,0,0,0,0,0,0,0,0,0,0,0,0,0,0,0,0,0,0,0,0,0,0,0,0,0,0,0,0,0,0,0,0,0,0,0,0,0,0,0,0,0,0,0,0,0,0,0,0,0,0,0,0,0,0,0,0,0,0,0,0,0,0,0,9,20,20,20,20,20,20,20,9
7,0,0,0,0,0,0,0,0,0,0,0,0,0,0,0,0,0,0,0,0,0,0,0,0,0,0,0,0,0,0,0,0,0,0,0,0,0,0,0,0,0,0,0,0,0,0,0,0,0,0,0,0,0,0,0,0,0,0,0,0,0,0,0,0,0,0,0,0,0,0,0,0,0,0,0,0,0,0,0,0,0,0,0,0,0,0,0,0,0,0,10,20,20,20,20,20,20,20,9
7,7,7,7,7,7,7,7,7,7,7,7,0,0,7,7,7,7,7,7,7,7,7,7,7,7,7,7,7,7,7,7,7,7,7,7,7,7,7,0,0,0,0,0,0,0,0,0,0,0,0,0,0,0,0,0,0,0,0,0,0,0,0,0,0,0,0,0,0,0,0,0,0,0,0,0,0,0,0,0,0,0,0,0,0,0,0,0,0,0,0,20,20,20,20,20,20,20,20,9
7,6,6,6,6,6,6,6,6,6,6,6,1,1,6,6,6,6,6,6,6,6,6,6,6,6,6,6,6,6,6,6,6,6,6,6,6,6,7,1,0,0,0,15,14,14,14,14,14,14,14,14,14,14,14,15,0,0,0,0,1,1,1,1,1,1,1,1,1,1,1,1,1,1,1,1,1,1,1,1,1,1,1,1,0,0,2,2,2,2,1,9,9,9,9,9,9,9,9,9
7,2,2,2,2,2,2,2,2,2,2,2,2,2,2,2,2,2,2,2,2,2,2,2,2,2,2,2,2,2,2,2,2,2,2,2,2,2,7,1,0,0,0,15,2,2,2,2,2,2,2,2,2,2,2,15,0,0,0,0,1,1,1,1,1,1,1,1,1,1,1,1,1,1,1,1,1,1,1,1,1,1,1,1,0,0,2,2,2,1,1,10,10,10,10,10,10,10,10,15
7,2,2,2,2,2,2,2,2,2,2,2,2,2,2,2,2,2,2,2,2,2,2,2,2,2,2,2,2,2,2,2,2,2,2,2,2,2,7,1,0,0,0,15,2,2,2,2,2,2,2,2,2,2,2,15,0,0,0,0,2,2,2,2,9,9,9,9,9,9,9,9,9,9,9,1,9,9,9,9,9,9,9,9,0,0,2,2,1,1,1,1,1,1,1,1,1,1,1,15
7,2,2,2,2,2,2,2,2,2,2,2,2,2,2,2,2,2,2,2,2,2,2,2,2,2,2,2,2,2,2,2,2,2,2,2,2,2,7,1,0,0,0,15,2,2,2,2,2,2,2,2,2,2,2,15,0,0,0,0,2,2,2,2,9,14,14,14,14,14,14,14,14,14,14,3,14,9,14,14,14,14,14,9,0,0,2,1,7,7,7,7,7,7,7,7,7,7,7,15
7,2,2,2,2,2,7,7,7,7,7,7,7,7,7,7,7,7,7,7,7,7,7,7,7,2,7,7,7,7,2,2,2,2,2,2,2,2,7,1,0,0,0,2,2,2,2,2,2,2,2,2,2,2,2,15,0,0,0,0,2,2,2,2,9,3,3,3,3,3,3,3,3,3,3,3,3,14,3,3,3,3,3,9,0,0,2,1,7,11,11,11,11,11,11,11,11,11,7,15
7,2,2,2,2,2,7,6,6,6,6,6,6,6,6,6,6,6,6,6,6,6,6,6,6,0,6,6,6,7,2,2,2,2,2,2,2,2,7,1,0,0,0,2,2,2,2,2,2,2,2,2,2,2,2,15,0,0,0,0,2,2,2,2,9,3,3,3,3,3,3,3,3,3,3,3,3,3,3,3,3,3,3,9,0,0,2,1,7,18,18,18,18,18,18,18,18,18,7,15
7,2,2,2,2,2,7,3,3,3,3,3,3,3,3,3,3,3,3,3,18,18,18,18,18,18,18,18,18,7,2,2,2,2,2,2,2,2,7,1,0,0,0,2,2,2,2,2,2,2,2,2,2,2,2,15,0,0,0,0,2,2,2,2,9,3,3,3,3,3,3,9,9,9,9,9,9,9,3,3,3,3,3,9,0,0,2,1,7,18,18,18,18,18,18,18,18,18,7,15
7,2,2,2,2,2,7,3,3,3,3,3,3,3,3,3,3,3,3,3,18,18,18,18,18,18,18,18,18,7,2,2,2,2,2,2,2,2,7,1,0,0,0,15,2,2,2,2,2,2,2,2,2,2,2,15,0,0,0,0,2,2,2,2,9,3,3,3,3,3,3,14,14,14,14,14,14,9,3,3,3,3,3,9,0,0,2,1,7,18,18,18,18,18,18,18,18,18,7,15
7,2,2,2,2,2,7,3,3,3,3,3,3,3,3,3,3,3,3,3,18,18,18,18,18,18,18,18,18,7,2,2,2,2,2,2,2,2,7,1,0,0,0,15,2,2,2,2,2,2,2,2,2,2,2,15,0,0,0,0,2,2,2,2,9,3,3,3,3,3,3,3,3,3,3,3,3,14,3,3,3,3,3,9,0,0,2,1,7,18,18,18,18,18,18,18,18,18,7,15
7,2,2,2,2,2,7,3,3,3,3,3,3,3,3,3,3,3,3,3,18,18,18,18,18,18,18,18,18,7,2,2,2,2,2,2,2,2,7,1,0,0,0,15,2,2,2,2,2,2,2,2,2,2,2,15,0,0,0,0,2,2,2,2,9,9,9,9,9,9,9,9,3,3,3,3,3,3,3,3,3,3,3,9,0,0,2,1,7,18,18,18,18,18,18,18,18,18,7,15
7,2,2,2,2,2,7,3,3,3,3,3,3,3,3,3,3,3,3,3,18,18,18,18,18,18,18,18,18,7,2,2,2,2,2,2,2,2,7,1,0,0,0,14,14,14,14,14,14,14,14,14,14,14,14,14,0,0,0,0,2,2,2,2,14,14,14,14,14,14,14,9,3,3,3,3,3,9,3,3,3,3,3,9,0,0,1,1,7,18,18,18,18,18,18,18,18,18,7,15
7,2,2,2,2,2,7,7,7,7,7,7,7,7,7,7,6,6,3,3,6,6,6,6,6,6,7,7,7,7,2,2,2,2,2,2,2,2,7,1,0,0,0,0,0,0,0,0,0,0,0,0,0,0,0,0,0,0,0,0,2,2,2,2,2,2,2,2,2,2,2,9,3,3,3,3,3,9,3,3,3,3,3,9,0,0,1,1,7,18,18,18,18,18,18,18,18,18,7,15
8,2,2,2,2,2,6,6,6,6,6,6,6,6,6,7,3,3,3,3,3,3,3,3,3,3,7,6,6,6,2,2,2,2,2,2,2,2,7,1,0,0,0,0,0,0,0,0,0,0,0,0,0,0,0,0,0,0,0,0,2,2,2,2,2,2,2,2,2,2,2,9,3,3,3,3,3,9,3,3,3,3,3,9,0,0,1,13,7,7,7,7,20,20,20,20,20,7,7,15
0,2,2,2,2,2,2,2,2,2,2,2,2,2,2,7,3,3,3,3,3,3,3,3,3,3,7,2,2,2,2,2,16,16,16,16,16,2,7,1,0,0,0,0,5,5,5,5,5,5,5,5,5,5,5,5,5,5,5,5,5,5,5,2,2,2,2,2,2,2,2,9,9,9,9,9,9,9,9,9,9,9,9,9,0,0,1,13,6,6,6,7,20,20,20,20,20,7,6,13
0,2,2,2,2,2,2,2,2,2,2,2,2,2,2,7,3,3,3,3,3,3,3,3,3,3,7,2,2,2,2,2,16,16,16,16,16,2,7,1,0,0,0,1,5,11,11,11,11,5,11,11,11,11,11,11,11,11,11,11,11,11,5,2,2,2,2,2,2,2,2,14,14,14,14,14,14,14,14,14,14,14,14,14,0,0,1,13,2,2,2,7,7,7,20,7,7,7,2,13
0,2,2,2,2,2,2,2,2,2,2,2,2,2,2,7,3,3,3,3,3,3,3,3,3,3,7,2,2,2,2,2,16,16,16,16,16,2,7,1,0,0,0,1,5,27,27,27,27,5,27,27,27,27,27,27,27,27,27,27,27,27,5,2,2,2,2,2,2,2,2,2,2,2,2,2,2,2,2,2,2,1,1,1,0,0,1,13,2,2,2,6,6,6,20,6,6,6,2,13
7,7,7,7,7,7,7,7,2,2,2,2,2,2,2,7,3,3,3,3,3,3,3,3,3,3,7,2,2,2,2,2,16,16,16,16,16,2,7,1,0,0,0,1,5,27,27,27,27,5,27,27,27,27,27,27,27,27,27,27,27,27,5,2,2,9,9,9,9,9,9,2,2,2,2,2,2,2,2,2,2,2,2,1,0,0,1,13,2,2,2,2,2,2,2,2,2,2,2,13
7,6,6,6,6,6,6,7,2,2,2,2,2,2,2,7,7,7,7,7,7,7,7,3,7,7,7,2,2,2,2,2,16,16,16,16,16,2,7,1,0,0,0,1,5,27,27,27,27,5,27,27,27,27,27,27,27,27,27,27,27,27,5,2,2,9,8,8,8,8,9,9,9,9,9,9,9,9,9,9,2,2,2,1,0,0,1,13,2,2,2,2,2,2,2,2,2,2,2,13
7,0,0,0,0,0,0,7,2,2,2,2,2,2,2,6,6,6,6,6,6,6,6,16,6,6,6,2,2,2,2,2,2,16,16,16,2,2,7,1,0,0,0,1,5,27,27,27,27,5,27,27,27,27,27,27,27,27,27,27,27,27,5,2,2,9,3,3,3,3,8,8,8,8,8,8,8,8,8,9,2,2,2,1,0,0,1,13,2,2,2,2,2,2,2,2,2,2,2,13
7,0,0,0,0,0,0,7,2,2,2,2,2,2,2,2,2,2,2,2,2,2,16,16,16,2,2,2,2,2,2,2,2,16,16,16,2,2,7,1,0,0,0,1,5,27,27,27,27,5,27,27,27,27,27,27,27,27,27,27,27,27,5,2,2,9,3,3,3,3,3,3,3,3,3,3,3,3,3,9,12,12,12,1,0,0,1,12,12,12,12,12,12,12,12,12,2,12,12,12
7,0,0,0,0,0,0,7,2,2,2,2,2,2,2,2,2,2,2,2,2,2,2,2,2,2,2,2,2,2,2,2,2,16,16,16,2,2,7,1,0,0,0,1,5,27,27,27,27,5,27,27,27,27,27,27,27,27,27,27,27,27,5,2,2,9,3,3,3,3,3,3,3,3,3,3,3,3,3,9,1,1,1,1,0,0,1,1,1,1,1,1,1,1,2,2,2,2,2,2
7,0,0,0,0,0,0,7,2,2,2,2,2,2,2,2,2,2,2,2,2,2,2,2,2,2,2,2,2,2,2,2,2,16,16,16,2,2,7,1,0,0,0,2,5,27,27,27,27,5,27,27,27,27,27,27,27,27,27,27,27,27,5,2,2,9,3,3,3,3,3,3,3,3,3,3,3,3,3,9,1,1,1,1,0,0,1,1,1,1,1,1,2,2,2,2,2,2,2,2
7,0,0,0,0,0,0,7,2,2,2,2,2,2,2,2,2,2,2,2,2,2,2,2,2,2,2,2,2,2,2,2,2,16,16,16,2,2,7,1,0,0,0,2,5,5,27,5,5,5,5,5,27,5,5,5,5,5,5,5,5,5,5,2,2,9,3,3,3,3,3,3,3,3,3,3,3,3,3,9,1,1,1,1,0,0,1,7,7,7,7,7,7,7,7,7,7,7,7,7
7,0,0,0,0,0,0,7,7,7,7,7,7,7,7,7,7,7,7,7,7,7,7,7,7,7,7,7,7,7,7,7,7,16,16,16,7,7,7,1,0,0,0,2,5,11,27,11,11,11,11,5,27,11,11,11,11,11,11,11,11,11,5,2,2,9,3,3,3,3,3,3,3,3,3,3,3,3,3,9,1,1,1,1,0,0,1,7,6,6,6,6,6,6,6,6,6,6,6,7
7,0,0,0,0,0,0,6,6,6,6,6,6,6,6,6,6,6,6,6,6,6,6,6,6,6,6,6,6,6,6,6,6,16,16,16,6,6,6,1,0,0,0,2,5,27,27,27,27,27,27,5,27,27,27,27,27,27,27,27,27,27,5,2,2,9,9,9,9,9,9,3,9,9,9,9,9,9,9,9,1,1,1,1,0,0,1,7,6,6,6,6,6,6,6,6,6,6,6,7
7,0,0,0,0,0,0,0,0,0,1,1,1,1,1,1,1,1,1,1,1,1,1,1,1,1,1,1,1,1,1,1,1,16,16,16,1,1,1,1,0,0,0,1,5,27,27,27,27,27,27,11,27,27,27,27,27,27,27,27,27,27,5,2,2,8,8,8,8,8,8,3,8,8,8,8,8,8,8,8,1,1,1,1,0,0,1,7,3,3,3,3,3,3,3,3,3,3,3,7
6,0,0,0,0,0,0,0,0,0,1,1,1,1,1,1,1,1,1,1,1,1,1,1,1,1,1,1,1,1,1,1,1,16,16,16,1,1,1,1,0,0,0,1,5,27,27,27,27,27,27,27,27,27,27,27,27,27,27,27,27,27,5,2,2,2,2,2,2,2,2,0,2,2,2,2,2,2,2,1,1,1,1,1,0,0,1,7,3,3,3,3,3,3,3,3,3,3,3,7
2,2,2,2,2,2,2,0,0,0,1,1,1,1,1,1,1,1,1,1,1,1,1,1,1,1,1,1,1,1,1,1,1,16,16,16,1,1,1,1,0,0,0,1,5,27,27,27,27,27,27,5,27,27,27,27,27,27,27,27,27,27,5,2,2,2,2,2,2,2,2,0,2,2,2,2,2,2,1,1,1,1,1,1,0,0,1,7,3,3,3,3,3,3,3,3,3,3,3,7
2,2,2,2,2,2,2,0,0,0,0,0,0,0,0,0,0,0,0,0,0,0,0,0,0,0,0,0,0,0,0,0,0,0,0,0,0,0,0,0,0,0,0,1,5,5,5,5,5,5,5,5,5,5,5,5,27,27,5,5,5,5,5,2,2,2,2,2,2,2,2,0,0,0,0,0,0,0,0,0,0,0,0,0,0,0,2,7,3,3,3,3,3,3,3,3,3,3,3,7
2,2,2,2,2,2,2,0,0,0,0,0,0,0,0,0,0,0,0,0,0,0,0,0,0,0,0,0,0,0,0,0,0,0,0,0,0,0,0,0,0,0,0,1,4,4,4,4,4,4,4,4,4,4,4,4,27,27,4,4,4,4,4,1,1,1,1,1,1,1,1,1,1,1,1,1,1,1,1,1,1,1,1,1,0,0,2,7,3,3,3,3,3,3,3,3,3,3,3,7
2,2,2,2,2,2,2,0,0,0,0,0,0,0,0,0,0,0,0,0,0,0,0,0,0,0,0,0,0,0,0,0,0,0,0,0,0,0,0,0,0,0,0,1,1,1,1,1,1,1,1,1,1,1,1,1,1,1,1,1,1,1,1,1,9,9,9,9,9,9,9,9,9,9,9,9,9,9,9,9,9,9,9,9,0,0,2,7,7,3,7,7,3,3,3,3,3,3,3,7
2,2,2,2,2,2,2,0,1,1,1,1,1,1,1,1,1,1,1,1,1,1,1,1,1,2,2,1,1,0,0,0,0,0,1,1,1,1,1,1,1,1,2,2,2,2,2,2,2,2,2,2,2,1,1,1,1,1,1,1,1,1,1,1,9,10,10,10,10,10,10,10,11,10,10,10,10,10,10,10,10,10,10,9,0,0,2,6,6,3,6,7,3,3,3,3,3,3,3,7
2,2,2,2,2,2,2,0,1,2,2,1,1,1,1,1,1,1,2,2,2,2,2,2,1,2,2,1,1,1,0,0,0,1,1,1,1,1,1,1,1,1,2,2,2,2,2,2,2,2,2,2,2,2,1,1,1,1,1,1,1,1,1,1,9,21,21,21,21,21,21,21,11,22,22,22,22,22,22,22,22,22,22,9,0,0,16,16,16,16,16,7,3,3,3,3,3,3,3,7
2,2,2,2,2,2,2,0,1,2,2,2,2,2,2,2,2,2,2,2,2,2,2,2,1,2,2,1,2,2,0,0,0,2,2,2,2,2,2,2,1,1,7,7,7,7,7,7,7,7,7,7,7,7,1,1,1,1,1,1,1,1,1,1,9,21,21,21,21,21,21,21,11,22,22,22,22,22,22,22,22,22,22,9,0,0,16,16,16,16,16,7,3,3,3,3,3,3,3,7
2,2,2,2,2,2,2,0,2,2,2,2,2,2,2,2,2,2,2,1,1,1,1,1,1,2,2,1,2,2,0,0,0,2,2,2,2,2,2,2,1,1,7,6,6,6,6,6,6,6,6,6,6,6,2,2,2,2,2,2,2,2,2,2,9,21,21,21,21,21,21,21,10,22,22,22,22,22,22,22,22,22,22,9,0,0,2,7,7,7,7,7,7,7,3,3,7,7,7,7
2,2,13,13,13,13,13,13,13,13,13,13,13,13,13,13,13,13,13,1,13,13,13,13,13,2,2,2,2,2,0,0,0,2,2,2,2,2,2,2,1,1,7,2,2,2,2,2,2,2,2,2,2,2,2,2,2,2,2,2,2,2,2,2,10,21,21,21,21,21,21,21,22,22,22,22,22,22,22,22,22,22,22,9,0,0,2,7,6,6,6,6,6,6,3,3,6,6,6,7
2,2,13,12,12,12,12,12,12,12,12,12,12,12,12,12,12,12,12,3,12,12,12,12,13,2,2,2,2,2,0,0,0,2,2,2,2,2,2,2,2,1,7,2,2,2,2,2,2,2,2,2,2,2,2,2,2,2,2,2,2,2,2,2,21,21,21,21,21,21,21,21,11,22,22,22,22,22,22,22,22,22,22,9,0,0,2,7,3,3,3,3,3,3,3,3,3,3,3,7
2,2,13,19,19,19,19,19,19,19,19,19,19,19,19,19,19,19,19,19,19,19,19,19,13,2,2,1,2,2,0,0,0,2,2,2,2,2,2,2,2,1,7,2,2,2,2,1,1,1,1,1,1,1,1,2,1,1,1,1,1,1,1,2,9,21,21,21,21,21,21,21,11,22,22,22,22,22,22,22,22,22,22,9,0,0,2,7,3,3,3,3,3,3,3,3,3,3,3,7
2,2,13,19,19,19,19,19,19,19,19,19,19,19,19,19,19,19,19,19,19,19,19,19,13,2,2,2,2,2,0,0,0,2,2,2,2,2,2,2,2,2,7,2,2,2,2,1,1,1,1,1,1,1,1,2,1,1,1,1,1,1,1,2,9,21,21,21,21,21,21,21,11,22,22,22,22,22,22,22,22,22,22,9,0,0,2,7,3,3,3,3,3,3,3,3,3,3,3,7
2,2,13,19,19,19,19,19,19,19,19,19,19,19,19,19,19,19,19,19,19,19,19,19,13,2,2,2,1,2,0,0,0,2,2,2,2,2,2,2,2,2,7,2,2,2,2,1,1,1,1,1,1,1,1,2,1,1,1,1,1,1,1,2,9,9,9,9,9,9,9,9,9,9,9,9,9,9,9,9,9,9,9,9,0,0,2,7,3,3,3,3,3,3,3,3,3,3,3,7
2,2,13,19,19,19,19,19,19,19,19,19,19,19,19,19,19,19,19,19,19,19,19,19,13,2,2,2,1,1,0,0,0,2,2,2,2,2,2,2,1,2,7,2,2,2,2,1,1,1,1,1,1,1,1,2,1,1,1,1,1,1,1,2,10,10,10,10,10,10,10,10,10,10,10,10,10,10,10,10,10,10,10,10,0,0,2,7,7,7,7,7,7,7,7,7,7,7,7,7
2,2,13,19,19,19,19,19,19,19,19,19,19,3,3,3,3,3,3,3,3,3,3,3,13,2,2,2,1,1,0,0,0,1,1,1,1,1,1,2,1,1,7,2,2,2,2,1,1,1,1,1,1,1,1,2,1,1,1,1,1,1,1,2,2,2,2,2,2,2,2,2,2,2,2,2,2,2,2,2,2,2,2,2,0,0,2,6,6,6,6,6,6,6,6,6,6,6,6,6
1,1,13,12,12,12,12,12,12,12,19,12,13,3,3,3,3,3,3,3,3,3,3,3,13,2,2,2,2,2,0,0,0,7,7,7,7,7,7,7,7,7,7,2,2,2,2,1,1,1,1,1,1,1,1,2,1,1,1,1,1,1,1,2,0,0,0,0,0,0,0,0,0,0,0,0,0,0,0,0,0,0,0,0,0,0,0,0,0,0,0,0,0,0,0,0,0,0,0,11
1,1,13,22,22,22,22,22,22,22,22,22,13,3,3,3,3,3,3,3,3,3,3,3,13,2,2,2,2,2,0,0,0,6,6,6,6,6,6,6,6,6,6,2,2,1,1,1,1,1,1,1,1,1,1,2,1,1,1,1,1,1,1,2,0,0,0,0,0,0,0,0,0,0,0,0,0,0,0,0,0,0,0,0,0,0,0,0,0,0,0,0,0,0,0,0,0,0,0,11
1,1,13,22,22,22,22,22,22,22,22,22,13,3,3,3,3,3,3,3,3,3,3,3,13,1,1,1,1,1,0,0,0,2,2,2,2,2,2,2,2,2,2,2,2,1,1,1,1,1,1,1,1,1,1,2,1,1,1,1,1,1,1,2,0,0,0,0,0,0,0,0,0,5,5,5,5,5,5,5,5,5,5,5,5,5,5,5,5,5,5,5,5,5,5,5,5,5,5,5
1,1,13,22,22,22,22,22,22,22,22,22,13,3,3,3,3,3,3,3,3,3,3,3,13,1,1,1,1,1,0,0,0,2,2,2,2,2,2,2,2,2,2,2,2,1,1,1,1,1,1,1,1,1,1,2,1,1,1,1,1,1,1,2,0,0,0,2,2,2,2,2,2,5,4,4,4,4,4,4,5,4,4,4,4,4,4,5,4,4,4,4,4,4,4,4,4,4,4,5
1,1,13,22,22,22,22,22,22,22,22,22,13,3,3,3,3,3,3,3,3,3,3,3,13,1,1,1,1,1,0,0,0,2,2,2,2,2,2,2,2,2,2,2,2,1,1,1,1,1,1,1,1,2,2,2,1,1,1,1,1,1,1,2,0,0,0,2,2,15,14,14,14,5,21,21,21,21,21,21,5,21,21,21,21,21,21,5,19,19,19,19,19,19,19,19,19,19,19,5
1,1,13,22,22,22,22,22,22,22,22,22,13,3,3,3,3,3,3,3,3,3,3,3,13,1,1,1,1,1,0,0,0,2,2,2,2,2,2,2,2,2,2,2,2,1,1,1,1,1,1,1,1,2,2,2,1,1,1,1,1,1,1,2,0,0,0,2,2,15,2,2,2,5,21,21,21,21,21,21,5,21,21,21,21,21,21,5,19,19,19,19,19,19,19,19,19,19,19,5
1,1,13,13,13,13,13,13,22,22,22,22,13,3,3,3,3,3,3,3,3,3,3,3,13,1,1,1,1,1,0,0,0,0,0,0,0,0,0,0,0,0,0,0,0,0,0,0,0,0,0,0,0,0,0,0,1,1,1,1,1,1,1,2,0,0,0,2,2,15,2,2,2,5,21,21,21,21,21,21,5,21,21,21,21,21,21,5,19,19,19,19,19,19,19,19,19,19,19,5
1,1,12,12,12,12,12,13,22,22,22,22,13,3,3,3,3,3,3,3,3,3,3,3,13,1,1,1,1,1,0,0,0,0,0,0,0,0,0,0,0,0,0,0,0,0,0,0,0,0,0,0,0,0,0,0,2,2,2,2,2,2,2,2,0,0,0,2,2,15,2,2,2,5,21,21,21,21,21,21,5,21,21,21,21,21,21,5,19,19,19,19,19,19,19,19,19,19,19,5
1,1,1,1,1,1,1,13,22,22,22,22,13,3,3,3,3,3,3,3,3,3,3,3,13,1,1,1,1,1,0,0,0,2,2,2,2,2,2,2,2,2,2,2,2,2,2,2,2,2,2,2,0,0,0,0,0,0,0,0,0,0,0,0,0,0,0,2,2,2,2,2,2,4,21,21,21,21,21,21,5,21,21,21,21,21,21,5,19,19,19,19,19,19,19,19,19,19,19,5
1,1,1,1,1,1,1,13,22,22,22,22,13,3,3,3,3,3,3,3,3,3,3,3,13,1,1,1,1,1,0,0,0,2,2,2,2,2,2,2,2,2,2,2,2,2,2,2,2,2,2,2,0,0,7,7,7,7,7,7,7,7,7,7,0,0,0,0,0,0,0,0,0,21,21,21,21,21,21,21,5,21,21,21,21,21,21,5,19,19,19,19,19,19,19,19,19,19,19,5
1,1,1,1,1,1,1,13,22,22,22,22,13,3,3,3,3,3,3,3,3,3,3,3,13,1,1,1,1,1,0,0,0,2,2,9,9,9,9,9,9,9,9,9,9,9,9,9,9,9,9,2,0,0,6,6,6,6,6,6,6,6,6,6,0,0,0,2,2,2,2,2,2,5,21,21,21,21,21,21,4,21,21,21,21,21,21,4,19,19,19,19,19,19,19,19,19,19,19,5
1,1,1,1,1,1,1,13,22,22,22,22,13,3,3,3,3,3,3,3,3,3,3,3,13,1,1,1,1,1,0,0,0,2,2,9,8,8,8,8,8,8,8,8,8,8,8,8,8,8,9,2,0,0,6,6,6,6,6,6,6,6,6,6,0,0,0,2,2,15,2,2,2,5,21,21,21,21,21,21,21,21,21,21,21,21,21,21,19,19,19,19,19,19,19,19,19,19,19,5
1,1,1,1,1,1,1,13,13,13,13,13,13,13,13,13,13,13,13,13,3,13,13,13,13,1,1,1,1,1,0,0,0,2,2,9,18,18,18,18,18,18,18,18,18,18,18,18,18,18,9,2,0,0,0,0,0,0,0,0,0,0,0,0,0,0,0,2,2,15,2,2,2,5,21,21,21,21,21,21,21,21,21,21,21,21,21,21,19,19,19,19,19,19,19,19,19,19,19,5
1,1,1,1,1,1,1,12,12,12,12,12,12,12,12,12,12,12,12,12,3,12,12,12,12,1,1,1,1,1,0,0,0,2,2,9,18,18,18,18,18,18,18,18,18,18,18,18,18,18,9,2,0,0,0,0,0,0,0,0,0,0,0,0,0,0,0,2,2,15,2,2,2,5,21,21,21,21,21,21,5,21,21,21,21,21,21,5,19,19,19,19,19,19,19,19,19,19,19,5
1,1,1,1,1,1,1,1,1,1,1,1,1,1,1,1,1,1,1,1,1,1,1,1,1,1,1,1,1,1,0,0,0,2,2,9,18,18,18,18,18,18,18,18,18,18,18,18,18,18,9,2,0,0,0,0,0,0,0,0,0,0,0,0,0,0,0,2,2,15,2,2,2,5,5,5,5,5,5,5,5,5,5,5,5,5,5,5,5,5,5,5,5,5,5,5,5,5,5,5
7,2,2,7,1,1,1,1,1,1,1,1,1,1,1,1,1,1,1,1,1,1,1,1,1,1,1,1,1,1,0,0,0,2,2,9,18,18,18,18,18,18,18,18,18,18,18,18,18,18,9,2,0,0,0,0,0,0,0,0,0,0,0,0,0,0,0,2,2,15,2,2,2,4,4,4,4,4,4,4,4,4,4,4,4,4,4,4,4,4,4,4,4,4,4,4,4,4,4,11
7,2,2,7,1,1,1,1,1,1,1,1,1,1,1,1,1,1,1,1,1,1,1,1,1,1,1,1,1,1,0,0,0,2,2,9,18,18,18,18,18,18,18,18,18,18,18,9,9,9,9,2,0,0,0,0,0,0,0,0,0,0,0,0,0,0,0,1,1,15,2,2,2,2,2,2,2,2,2,2,2,2,2,2,2,2,2,2,2,2,2,2,2,2,2,2,2,2,2,11
7,16,16,7,1,1,1,1,1,1,1,1,1,1,1,1,1,1,1,1,1,1,1,1,1,1,1,1,1,1,0,0,0,2,2,9,18,18,18,18,18,18,18,18,18,18,18,9,8,8,8,2,0,0,0,1,1,1,1,1,1,1,1,1,1,1,1,1,1,15,2,2,2,2,2,2,2,2,2,2,2,2,2,2,2,2,2,2,2,2,2,2,2,2,2,2,2,2,2,11
7,16,16,7,7,7,7,7,7,7,7,7,7,7,7,7,7,7,7,7,7,7,7,7,7,7,7,7,7,2,0,0,0,2,2,9,9,9,9,9,9,18,9,9,9,9,9,9,2,2,2,2,0,0,0,1,1,1,1,1,9,9,9,9,9,9,9,9,9,9,9,9,9,9,9,2,2,2,2,2,2,2,2,2,2,2,2,2,2,2,2,2,2,2,2,2,2,2,2,11
7,16,16,6,6,6,6,6,6,6,6,6,6,6,6,6,6,6,6,6,6,6,6,6,6,6,6,6,6,2,0,0,0,2,2,8,8,8,8,8,8,18,8,8,8,8,8,8,2,2,2,2,0,0,0,1,1,1,1,1,9,8,8,8,8,8,8,9,8,8,8,8,8,8,9,2,2,2,2,2,2,2,2,2,2,2,2,2,2,2,2,2,2,2,2,2,2,2,2,11
7,16,16,1,1,1,1,1,1,1,1,1,1,1,1,1,1,1,1,1,1,1,1,1,1,1,1,1,1,1,0,0,0,1,1,1,16,16,16,16,16,16,16,16,16,16,16,1,1,1,1,1,0,0,0,1,1,1,1,1,9,17,17,17,17,17,17,9,17,17,17,17,17,17,9,2,2,2,2,2,2,2,2,2,2,2,2,2,2,2,2,2,2,2,2,2,2,2,2,11
7,16,16,16,16,16,16,16,16,16,16,16,16,16,16,16,16,16,16,16,16,16,16,16,2,2,2,2,2,2,0,0,0,1,1,1,1,1,1,1,1,1,1,1,1,1,1,1,1,1,1,1,0,0,0,1,1,1,1,1,8,17,17,17,17,17,17,9,17,17,17,17,17,17,8,2,2,2,2,2,2,2,2,2,2,2,2,2,2,2,2,2,2,2,2,2,2,2,2,11
7,16,16,1,1,1,1,1,1,1,1,1,1,1,1,1,1,1,1,1,1,16,16,16,0,0,0,0,0,0,0,0,0,0,0,0,0,0,0,0,0,0,0,0,0,0,0,0,0,0,0,0,0,0,0,1,1,1,1,1,17,17,17,17,17,17,17,9,17,17,17,17,17,17,16,2,2,2,2,2,2,2,2,2,2,2,2,2,2,2,2,2,2,2,2,2,2,2,2,11
7,16,16,1,1,1,1,13,13,13,13,13,13,13,13,13,13,1,13,13,13,13,1,2,0,0,0,0,0,0,0,0,0,0,0,0,0,0,0,0,0,0,0,0,0,0,0,0,0,0,0,0,0,0,0,1,1,1,1,1,9,17,17,17,17,17,17,9,17,17,17,17,17,17,9,2,2,2,2,2,2,2,2,2,2,2,2,2,2,2,2,2,2,2,2,2,2,2,2,11
7,16,16,1,1,1,1,13,12,12,12,12,12,12,12,13,12,3,12,12,12,13,2,2,0,0,0,0,0,0,0,0,0,0,0,0,0,0,0,0,0,0,0,0,0,0,0,0,0,0,0,0,0,0,0,1,1,1,1,1,9,17,17,17,17,17,17,9,17,17,17,17,17,17,9,10,10,10,10,10,10,10,10,10,10,10,10,10,10,10,10,10,10,10,10,10,10,10,10,11
13,13,13,13,13,13,13,13,3,3,3,3,3,3,3,13,3,3,3,3,3,13,2,2,2,2,2,2,2,2,2,1,1,1,1,1,1,1,1,1,1,1,1,1,1,1,1,1,1,1,1,1,1,1,1,1,1,1,1,1,9,17,17,17,17,17,17,9,17,17,17,17,17,17,9,11,11,11,11,11,11,11,11,11,11,11,11,11,11,11,7,7,7,7,7,7,7,7,7,7
13,12,12,12,12,12,12,13,3,3,3,3,3,3,3,13,3,3,3,3,3,13,1,2,2,2,2,2,2,2,1,1,1,1,1,1,1,1,1,1,1,1,1,1,1,1,1,1,1,1,1,1,1,1,1,1,1,1,1,1,9,17,17,17,17,17,17,9,17,17,17,17,17,17,9,2,2,2,2,2,2,2,2,2,2,2,2,2,2,2,7,6,6,6,6,6,6,6,6,7
13,3,3,3,3,3,3,13,3,3,3,3,3,3,3,12,3,3,3,3,3,13,1,1,1,1,1,1,1,1,1,1,1,1,1,1,1,1,1,1,1,1,1,1,1,1,1,1,1,1,1,1,1,1,1,1,1,1,1,1,9,17,17,17,17,17,17,9,17,17,17,17,17,17,9,2,2,2,2,2,2,2,2,2,2,2,2,2,2,2,7,17,17,17,17,17,17,17,17,7
13,3,3,3,3,3,3,12,3,3,3,3,3,3,3,3,3,3,3,3,3,13,1,1,1,1,1,1,1,1,1,1,1,1,1,1,1,1,1,1,1,1,1,1,1,1,1,1,1,1,1,1,1,1,1,1,1,1,1,1,9,17,17,17,17,17,17,8,17,17,17,17,17,17,9,2,2,2,2,2,2,2,7,7,7,1,7,7,7,7,7,17,17,17,17,17,17,17,17,7
13,3,3,3,3,3,3,3,3,3,3,3,3,3,3,3,3,3,3,3,3,13,1,1,1,1,1,1,1,1,1,1,1,1,1,1,1,1,1,1,1,1,1,1,1,1,1,1,1,1,1,1,1,1,1,1,1,1,1,1,9,17,17,17,17,17,17,17,17,17,17,17,17,17,9,2,2,2,2,2,2,2,7,6,6,16,6,6,6,6,6,17,17,17,17,17,17,17,17,7
13,13,13,13,3,13,13,13,13,13,13,3,13,13,13,13,3,3,3,3,3,13,1,1,1,1,1,1,1,1,1,1,1,1,1,1,1,1,1,1,1,1,1,1,1,1,1,1,1,1,1,1,1,1,1,1,1,1,1,1,9,17,17,17,17,17,17,9,17,17,17,17,17,17,9,2,2,2,2,2,2,2,7,16,16,16,16,16,16,16,16,17,17,17,17,17,17,17,17,7
13,12,12,12,3,12,12,13,12,12,12,3,12,12,12,13,3,3,3,3,3,13,1,1,1,1,1,1,1,1,1,1,1,1,1,1,1,1,1,1,1,1,1,1,1,1,1,1,1,1,1,1,1,1,1,1,1,1,1,1,9,17,17,17,17,17,17,9,17,17,17,17,17,17,9,2,2,2,2,2,2,2,7,16,16,16,16,16,16,16,7,17,17,17,17,17,17,17,17,7
13,3,3,3,3,3,3,13,3,3,3,3,3,3,3,13,3,3,3,3,3,13,1,1,1,1,1,1,1,1,1,1,1,1,1,1,1,1,1,1,1,1,1,1,1,1,1,1,1,1,1,1,1,1,1,1,1,1,1,1,9,17,17,17,17,17,17,9,17,17,17,17,17,17,9,2,2,2,2,2,2,2,7,16,16,16,16,16,16,16,7,17,17,17,17,17,17,17,17,7
13,3,3,3,3,3,3,13,3,3,3,3,3,3,3,13,3,3,3,3,3,13,1,1,1,1,1,1,1,1,1,1,1,1,1,1,1,1,1,1,1,1,1,1,1,1,1,1,1,1,1,1,1,1,1,1,1,1,1,1,9,17,17,17,17,17,17,9,17,17,17,17,17,17,9,2,2,2,2,2,2,2,7,16,16,16,16,16,16,16,7,17,17,17,17,17,17,17,17,7
13,3,3,3,3,3,3,13,3,3,3,3,3,3,3,13,3,3,3,3,3,13,1,1,1,1,1,1,1,1,1,1,1,1,1,1,1,1,1,1,1,1,1,1,1,1,1,1,1,1,1,1,1,1,1,1,1,1,1,1,9,17,17,17,17,17,17,9,17,17,17,17,17,17,8,2,2,2,2,2,2,2,7,16,16,16,16,16,16,16,7,17,17,17,17,17,17,17,17,7
13,3,3,3,3,3,3,13,3,3,3,3,3,3,3,13,3,3,3,3,3,13,1,1,1,1,1,1,1,1,1,1,1,1,1,1,1,1,1,1,1,1,1,1,1,1,1,1,1,1,1,1,1,1,1,1,1,1,1,1,9,17,17,17,17,17,17,9,17,17,17,17,17,17,17,2,2,2,2,2,2,2,7,7,7,7,7,7,7,7,7,17,17,17,17,17,17,17,17,7
13,3,3,3,3,3,3,13,3,3,3,3,3,3,3,13,3,3,3,3,3,13,10,10,10,10,10,10,10,10,10,10,10,10,10,10,10,10,10,10,10,10,10,10,10,10,10,10,10,10,10,10,10,10,10,10,10,10,10,10,9,9,9,9,9,9,9,9,9,9,9,9,9,9,9,2,2,10,10,10,10,10,10,10,10,10,10,10,10,10,7,7,7,7,7,7,7,7,7,7
13,13,13,13,13,13,13,13,13,13,13,13,13,13,13,13,13,13,13,13,13,13,10,10,10,10,10,10,10,10,10,10,10,10,10,10,10,10,10,10,10,10,10,10,10,10,10,10,10,10,10,10,10,10,10,10,10,10,10,10,8,8,8,8,8,8,8,8,8,8,8,8,8,8,8,6,6,11,11,11,11,11,11,11,11,11,11,11,11,11,11,11,11,11,11,11,11,11,11,11
